NO ./textures/fire.xpm
SO ./textures/fire.xpm
EA ./textures/fire.xpm
WE ./textures/fire.xpm

C 180, 30, 30
F 220, 70, 70

111111111111111111
1E0000000000010001
111011001100110011
100001001110000111
100101101000000011
100000111111101111
110000000111101111
111100000011101111
111111001111001111
111100000000000111
111000000000000001
100100000000100001
100001000110000001
100000000000000001
100011001000010001
100010000000000001
100000100101000001
100100001000000001
100000010001001001
100010000010000001
100001000001100011
101000000100000101
111100000000000001
111111111111111111