NO ./textures/water.xpm
SO ./textures/wood2.xpm
WE ./textures/fire.xpm
EA ./textures/galvanized_blue.xpm
F 255,100, 0
C 255,255,255

     1111111111111111111111111
     1000000000110000000000001
     1011000001110000000000001
     1001000000000000000000001
111111111011000001110000000001
100000000011000001110111111111
11110111111111011100000010001
11110111111111011101010111000
11000000110101011100000010000
10000000000000001100000N01001
10000000000000001101010010001
11000001110101011111011110001
11110111 1110101 101111010001 
11111111 1111111 111111111111