NO ./textures/wood2.xpm
EA ./textures/water.xpm
WE ./textures/fire.xpm
SO ./textures/galvanized_blue.xpm
F 100 , 100  , 100 
C 30 ,  200 ,  100 

1111111111111111111111111111111111111
1000000000000000000111111111111111111
10E0000000000000000000000000000000001
1000000000000000000000000000000000001
1000000001000000000000000001000000001
1000000000000000010000000000000000001
1000000000000000001000000000000000001
1000000000000001000000000000000000001
1000000001000000000000000001000000001
1000000000000000000000000000000000001
1000000000000000000000000000000000001
1111111111111111111111111111111111111